null,,,,,,,,,,,,,,,
2,2,2,2,2,2,2,2,2,2,2,2,2,2,2,2
2,0,0,0,0,0,0,0,0,0,1,0,0,0,0,2
2,0,5>add:10,0,0,0,0,0,0,0,1,0,0,0,0,2
2,0,0,0,0,0,0,0,0,0,1,0,6,0,0,2
2,2,2,2,2,0,0,0,2,2,2,2,2,2,2,2
2,0,0,0,0,0,0,0,0,0,0,1,0,0,0,2
2,0,0,0,0,0,0,0,0,0,0,1,0,0,0,2
2,0,0,0,0,0,0,0,0,0,0,1,0,0,0,2
2,2,2,2,2,2,2,2,2,2,2,0,0,0,0,2
2,0,0,0,0,0,0,0,0,0,0,0,0,0,0,2
2,0,0,0,0,0,0,0,0,0,0,0,0,0,0,2
2,0,0,0,0,0,0,0,0,0,0,0,0,1,1,2
2,0,0,0,0,0,0,0,0,0,0,0,0,0,0,2
2,0,0,0,0,0,8>speed:1.0/start:0^0^0/end:4^0^0,8>speed:1.0/start:0^0^0/end:4^0^0,0,0,0,0,0,0,0,2
2,0,0,0,0,0,0,0,0,0,0,0,0,0,0,2
2,0,0,0,0,0,0,0,0,0,0,0,0,0,0,2
2,0,s,0,0,0,0,0,0,0,0,0,0,0,0,2
2,2,2,2,2,2,2,2,2,2,2,2,2,2,2,2
