null,,,,,,,,,,,,,,,
2,2,2,2,2,2,2,2,2,2,2,2,2,2,2,2
2,0,0,0,0,0,0,0,0,0,3>range:2/power:10,0,0,0,0,2
2,0,0,0,0,0,0,0,0,0,0,0,0,0,0,2
2,0,0,0,0,0,0,0,0,0,0,0,6,0,0,2
2,0,0,0,0,0,0,0,0,3>range:2/power:10,2,2,2,2,2,2
2,0,0,0,0,0,0,0,0,0,0,0,0,0,0,2
2,0,0,0,0,1>hp:20,0,0,0,0,0,0,0,0,0,2
2,0,0,0,0,0,0,0,0,0,0,0,0,0,0,2
2,0,0,0,0,0,0,0,0,0,0,0,0,0,0,2
2,2,2,2,2,2,0,0,0,0,2,2,2,2,2,2
2,0,0,0,1,0,0,0,0,0,0,1,0,0,0,2
2,0,0,0,1,0,0,0,0,0,0,1,0,0,0,2
2,0,0,0,3>range:2/power:10,0,0,0,0,0,0,3>range:2/power:10,0,0,0,2
2,0,0,0,2,2,2,2,2,2,2,2,0,0,0,2
2,0,0,0,1,0,0,0,0,0,0,1,0,0,0,2
2,0,0,0,1,0,0,0,0,0,0,1,0,0,0,2
2,2,2,2,2,2,0,0,0,0,2,2,2,2,2,2
2,0,0,0,0,0,0,0,0,0,0,0,0,0,0,2
2,0,0,0,0,0,0,0,0,0,0,0,0,0,0,2
2,0,0,0,0,0,0,0,0,0,0,0,0,0,0,2
2,0,0,0,0,0,1,1,1,1,0,0,0,0,0,2
2,0,0,0,0,0,0,0,0,0,0,0,0,0,0,2
2,1,1,0,0,0,0,0,0,0,0,0,0,1,1,2
2,0,0,0,0,0,0,0,0,0,0,0,0,0,0,2
2,0,0,0,0,0,0,0,0,0,0,0,0,0,0,2
2,1,1,1,0,0,0,0,0,0,0,0,1,1,1,2
2,0,0,0,0,0,0,0,0,0,0,0,0,0,0,2
2,0,0,0,0,0,0,0,0,0,0,0,0,0,0,2
2,0,0,0,0,0,0,0,s,0,0,0,0,0,0,2
2,2,2,2,2,2,2,2,2,2,2,2,2,2,2,2
