2,2,2,2,2,2,2,2,2,2,2,2,2,2,2,2
2,0,0,0,0,0,0,0,0,0,0,0,0,0,0,2
2,0,0,0,0,0,0,0,0,0,0,0,0,0,0,2
2,0,0,0,0,0,0,0,0,0,0,0,6,0,0,2
2,0,0,0,0,0,0,0,0,0,2,2,2,2,2,2
2,1>hp:20,1>hp:20,1>hp:20,1>hp:20,0,0,2,2,0,0,0,0,0,0,2
2,0,0,0,1>hp:20,0,0,0,0,0,0,0,0,0,0,2
2,s,0,0,1>hp:20,0,5,5,5,0,7,0,0,0,0,2
2,2,2,2,2,2,2,2,2,2,2,2,2,2,2,2
