2,2,2,2,2,2,2,2,2,2,2,2,2,2,2,2
2,0,0,0,0,0,0,0,0,0,0,0,0,0,0,2
2,0,0,0,0,0,0,0,0,0,0,0,0,0,0,2
2,0,0,0,0,0,0,0,0,0,0,0,0,6,0,2
2,0,0,0,0,0,0,0,0,0,2,2,2,2,2,2
2,0,0,0,0,0,0,0,0,0,0,0,0,0,0,2
2,0,0,0,0,0,0,0,0,0,0,0,0,0,0,2
2,0,0,0,0,0,0,0,0,0,7,0,0,0,0,2
2,0,0,0,0,0,0,0,2,2,2,2,2,2,2,2
2,0,0,0,0,0,0,0,2,0,0,0,0,0,0,2
2,0,0,0,0,1,1,1,2,0,0,0,0,0,0,2
2,0,0,0,0,0,0,0,2,0,0,0,0,0,0,2
2,0,s,0,0,0,0,0,2,0,0,0,0,0,0,2
2,2,2,2,2,2,2,2,2,2,2,2,2,2,2,2
